............#############......................................
............#...........#......................................
............#.#############....................................
............#.#.........#.#....................................
............#.#.......#######..................................
............#.#.........#.#.#..................................
............#.#.........#.#.#.......................###########
............#.#.........#.#.#.......................#.........#
..##########x.#.........#.#.#.......................#.........#
..#...........#.........#.#.#.......................#.........#
#############.#.........#.#.#.......................#.........#
#.#.........#.#.........#.#.#.......................#.........#
#.#.........#.###########.###########.....###########.........#
#.#.........#...............#.......#.....#...................#
#.#.........#...............###########.###########...........#
#.#.........#.......................#.#.#.#.......#...........#
#.#.........#.......................#.#.#.#.......#...........#
#.#.........#.......................#.#.#.#.......#...........#
#.#.........#.......................#.#.#.#.......#.###########
#.#.........#.......................#.#.#.#.......#.#..........
#.###########.......................#.#.#.#.......#.#..........
#...................................#.#.#.#.......#.#..........
########^...........................#######.......#.#..........
......................................#.#.........#.#..........
......................................#############.#..........
........................................#...........#..........
........................................#############..........